111111111111111111111111111111111111111111111
1X01C001110C0000000000000X000000000X0XX011001
10000111110X000000000011111111100001000000001
100011100P0X000X0111111000000001100C00XXXX001
100111XX000000C0001111100X000C000000XX0001001
10111111111000000000000C00000111110000100X001
1000X000000C000011110000C00011110000000101001
10X000001111100000000000000011111100X00000X01
1000X00C000X0001110X000000111110X000000000XE1
111111111111111111111111111111111111111111111