1111111111111
1X01C00C000C1
10000111110X1
1P011E0000001
1111111111111