1111111111111
1X01C00C000C1
10000111110X1
100011E00P0X1
1111111111111